11111111
1EE00001
1C000001
100000P1
11111111
