11111111
1E000011
1C000001
10000PP1
11111111
