11111111
1EE00001
1C000001
10000PP1
11111111
