111111
1P0C11
100TC1
1CE001
111111
