111111111111111111111111111111111111111111111111111111111111111111111111111111111111111111111111111
1000000P0000000111111111111111111111111111111111111111111111111111111111111111111111111111111111111
100000000000111111111111111111111111111111111111111111111111111111111111111111111111111111111111111
100000C00001111000111111111111111100000000000000111111111111111111111111111111111111111111111111111
1000000000000E0010000000000000000000000000011111111111111111111111111111111111111111111111111111111
111111111111111111111111111111111111111111111111111111111111111111111111111111111111111111111111111
