111111
1P0C11
1010C1
11E101
111111
