111111
1P0C11
1000C1
1CE001
111101
