111111
1P0011
100001
10E001
111111
