111111
1P0C11
1000C1
1C00E1
111111
