1111111111111111111111111111111111111111111111111
100P0000000000C1111111111111111111111111111111111
10000000000C1111111111111111111111111111111111111
100000CCCCC11111111111111111111111000000000000001
1C000000000000000E00000000000000000000000C0111111
1111111111111111111111111111111111111111111111111
