1111111111111111111111111111111111111111111111111111111111111111
100P0000000000C1111111111111111111111111111111111111111111111111
10000000000C1111111111111111111111111111111111111111111111111111
100000CCCCC111111111111111111111110000000000000000000000000000C1
1C000000000000000E00000000000000000000000C0111111111111111111111
1111111111111111111111111111111111111111111111111111111111111111
